 population: population for community: (numeric - decimal)
 householdsize: mean people per household (numeric - decimal)
 racepctblack: percentage of population that is african american (numeric - decimal)
 racePctWhite: percentage of population that is caucasian (numeric - decimal)
 racePctAsian: percentage of population that is of asian heritage (numeric - decimal)
 racePctHisp: percentage of population that is of hispanic heritage (numeric - decimal)
 agePct12t21: percentage of population that is 12-21 in age (numeric - decimal)
 agePct12t29: percentage of population that is 12-29 in age (numeric - decimal)
 agePct16t24: percentage of population that is 16-24 in age (numeric - decimal)
 agePct65up: percentage of population that is 65 and over in age (numeric - decimal)
 numbUrban: number of people living in areas classified as urban (numeric - decimal)
 pctUrban: percentage of people living in areas classified as urban (numeric - decimal)
 medIncome: median household income (numeric - decimal)
 pctWWage: percentage of households with wage or salary income in 1989 (numeric - decimal)
 pctWFarmSelf: percentage of households with farm or self employment income in 1989 (numeric - decimal)
 pctWInvInc: percentage of households with investment / rent income in 1989 (numeric - decimal)
 pctWSocSec: percentage of households with social security income in 1989 (numeric - decimal)
 pctWPubAsst: percentage of households with public assistance income in 1989 (numeric - decimal)
 pctWRetire: percentage of households with retirement income in 1989 (numeric - decimal)
 medFamInc: median family income (differs from household income for non-family households) (numeric - decimal)
 perCapInc: per capita income (numeric - decimal)
 whitePerCap: per capita income for caucasians (numeric - decimal)
 blackPerCap: per capita income for african americans (numeric - decimal)
 indianPerCap: per capita income for native americans (numeric - decimal)
 AsianPerCap: per capita income for people with asian heritage (numeric - decimal)
 OtherPerCap: per capita income for people with 'other' heritage (numeric - decimal)
 HispPerCap: per capita income for people with hispanic heritage (numeric - decimal)
 NumUnderPov: number of people under the poverty level (numeric - decimal)
 PctPopUnderPov: percentage of people under the poverty level (numeric - decimal)
 PctLess9thGrade: percentage of people 25 and over with less than a 9th grade education (numeric - decimal)
 PctNotHSGrad: percentage of people 25 and over that are not high school graduates (numeric - decimal)
 PctBSorMore: percentage of people 25 and over with a bachelors degree or higher education (numeric - decimal)
 PctUnemployed: percentage of people 16 and over, in the labor force, and unemployed (numeric - decimal)
 PctEmploy: percentage of people 16 and over who are employed (numeric - decimal)
 PctEmplManu: percentage of people 16 and over who are employed in manufacturing (numeric - decimal)
 PctEmplProfServ: percentage of people 16 and over who are employed in professional services (numeric - decimal)
 PctOccupManu: percentage of people 16 and over who are employed in manufacturing (numeric - decimal) ########
 PctOccupMgmtProf: percentage of people 16 and over who are employed in management or professional occupations (numeric - decimal)
 MalePctDivorce: percentage of males who are divorced (numeric - decimal)
 MalePctNevMarr: percentage of males who have never married (numeric - decimal)
 FemalePctDiv: percentage of females who are divorced (numeric - decimal)
 TotalPctDiv: percentage of population who are divorced (numeric - decimal)
 PersPerFam: mean number of people per family (numeric - decimal)
 PctFam2Par: percentage of families (with kids) that are headed by two parents (numeric - decimal)
 PctKids2Par: percentage of kids in family housing with two parents (numeric - decimal)
 PctYoungKids2Par: percent of kids 4 and under in two parent households (numeric - decimal)
 PctTeen2Par: percent of kids age 12-17 in two parent households (numeric - decimal)
 PctWorkMomYoungKids: percentage of moms of kids 6 and under in labor force (numeric - decimal)
 PctWorkMom: percentage of moms of kids under 18 in labor force (numeric - decimal)
 NumIlleg: number of kids born to never married (numeric - decimal)
 PctIlleg: percentage of kids born to never married (numeric - decimal)
 NumImmig: total number of people known to be foreign born (numeric - decimal)
 PctImmigRecent: percentage of _immigrants_ who immigated within last 3 years (numeric - decimal)
 PctImmigRec5: percentage of _immigrants_ who immigated within last 5 years (numeric - decimal)
 PctImmigRec8: percentage of _immigrants_ who immigated within last 8 years (numeric - decimal)
 PctImmigRec10: percentage of _immigrants_ who immigated within last 10 years (numeric - decimal)
 PctRecentImmig: percent of _population_ who have immigrated within the last 3 years (numeric - decimal)
 PctRecImmig5: percent of _population_ who have immigrated within the last 5 years (numeric - decimal)
 PctRecImmig8: percent of _population_ who have immigrated within the last 8 years (numeric - decimal)
 PctRecImmig10: percent of _population_ who have immigrated within the last 10 years (numeric - decimal)
 PctSpeakEnglOnly: percent of people who speak only English (numeric - decimal)
 PctNotSpeakEnglWell: percent of people who do not speak English well (numeric - decimal)
 PctLargHouseFam: percent of family households that are large (6 or more) (numeric - decimal)
 PctLargHouseOccup: percent of all occupied households that are large (6 or more people) (numeric - decimal)
 PersPerOccupHous: mean persons per household (numeric - decimal)
 PersPerOwnOccHous: mean persons per owner occupied household (numeric - decimal)
 PersPerRentOccHous: mean persons per rental household (numeric - decimal)
 PctPersOwnOccup: percent of people in owner occupied households (numeric - decimal)
 PctPersDenseHous: percent of persons in dense housing (more than 1 person per room) (numeric - decimal)
 PctHousLess3BR: percent of housing units with less than 3 bedrooms (numeric - decimal)
 MedNumBR: median number of bedrooms (numeric - decimal)
 HousVacant: number of vacant households (numeric - decimal)
 PctHousOccup: percent of housing occupied (numeric - decimal)
 PctHousOwnOcc: percent of households owner occupied (numeric - decimal)
 PctVacantBoarded: percent of vacant housing that is boarded up (numeric - decimal)
 PctVacMore6Mos: percent of vacant housing that has been vacant more than 6 months (numeric - decimal)
 MedYrHousBuilt: median year housing units built (numeric - decimal)
 PctHousNoPhone: percent of occupied housing units without phone (in 1990, this was rare!) (numeric - decimal)
 PctWOFullPlumb: percent of housing without complete plumbing facilities (numeric - decimal)
 ViolentCrimesPerPop: total number of violent crimes per 100K popuation (numeric - decimal) GOAL attribute (to be predicted)
 NonViolentCrimesPerPop: total number of violent crimes per 100K popuation (numeric - decimal) GOAL attribute (to be predicted)
